████████████████████████████████████████████████████████████████████████████████████████████████████████████████████████
█                                                                                                                      █
█                                                                                                                      █
█                                                                                                                      █
█                            11111111                                                                                  █
█                          111111111111                                                                                █
█                          11111111111111                                                                              █
█                          111111111111222222222222333333333333333                                                     █
█                           11111111111222222222222222233333333333333                                                  █
█                            11111111111222222222222222233333333333333                                                 █
█                            1111111111112222222222222222232333333333333                                               █
█                             1111111111121122222222222322233333333333333                                              █
█                              11111111121112121122222233223333332333333333                                            █
█                               11111111121212111122222233233233333333333333                                           █
█                               111111111121111111122222232333333333333333 3                                           █
█                                  11111112211111112222223323233333333333                                              █
█                                      1111121212211222222323223333333333                                              █
█                                        1111111111112122232323233323333                                               █
█                                              121111112222333233332333                                                █
█                                               2111111222222333333333                                                 █
█                                               2 111122222233333333                                                   █
█                                                 2222221222233333                                                     █
█                                                                                                                      █
█                                                                                                                      █
█                                                                                                                      █
█                                                                                                                      █
█                                                                                                                      █
█                                                                                                                      █
█                                                                                                                      █
█                                                                                                                      █
█                                                                                                                      █
█                                                                                                                      █
█                                                                                                                      █
█                                                                                                                      █
█                                                                                                                      █
█                                                                                                                      █
████████████████████████████████████████████████████████████████████████████████████████████████████████████████████████