████████████████████████████████████████████████████████████████████████████████████████████████████████████████████████
█                                                                                                                      █
█                                                                                                                      █
█   █                     █                                                                                            █
█                                                                                                                      █
█                                                                                                                      █
█                                                                                                                      █
█                                                                                                                      █
█                       ▌                                                                                              █
█                 ▄▄▄▄▄▄▌                                                       ██████████                             █
█                       ▌                                                       █                                      █
█                       ▌                                                       ██████                                 █
█                                                                             ███  █                                   █
█    █                    █                                                  ██ █  █                                   █
█                                                        ,               ████████                                      █
█                                                                                                                      █
█                        █                              ,                                                              █
█                        █                             ,  █ █                                                          █
█                        ███████████                   ██████████                                                      █
█                        █                                █ █                                                          █
█                        █                             █████████                                                       █
█                                              ,          █ █                                                          █
█                                             ,           █ █                                                          █
█                                                         █ █                                                          █
█                                                                                                                      █
█                                                                                                                      █
█                                                                                                                      █
█                                                                                                                      █
█                                                                                                                      █
█                                                                                                                      █
█                                                                                                                      █
█                                                                                                                      █
█                                                                                                                      █
█                                                                                                                      █
█                                                                                                                      █
█                                                                                                                      █
████████████████████████████████████████████████████████████████████████████████████████████████████████████████████████