████████████████████████████████████████████████████████████████████████████████████████████████████████████████████████
█                                                                                                                      █
█                    99999999999999999999999999999999999999999999999999999999999999                                    █
█                    99999999999999999999999999999999999999999999999999999999999999                                    █
█                    99999999999955555555555555555555555555555555555555555999999999                                    █
█                    999999999955555555555                       555555555555555599                                    █
█                    999999999955559993333                       555555555555555559                                    █
█                    999999999559955559333                       555555555555555599                                    █
█                    999999999555555593333                       555555555555555599                                    █
█                                                                                                                      █
█                                                                                                                      █
█                                                                                                                      █
█                                                                                                                      █
█                                                                                                                      █
█                    999999999555593393993                       555555555555555999                                    █
█                    999999999595553333333                       555555555555555599                                    █
█                    999999999555555553333                       555555555555555599                                    █
█                    999999999955999995559                       555555555555555599                                    █
█                    999999999995599999553                       555555555555555599                                    █
█                    999999999999555555555                       555555555555555599                                    █
█                    999999999999999999955                       555955555555555599                                    █
█                    999999999999999999999                       999999999999999999                                    █
█                    999999999999999999999                       999999999999999999                                    █
█                                                                                                                      █
█                                                                                                                      █
█                                                                                                                      █
█                                                                                                                      █
█                                                                                                                      █
█                                                                                                                      █
█                                                                                                                      █
█                                                                                                                      █
█                                                                                                                      █
█                                                                                                                      █
█                                                                                                                      █
█                                                                                                                      █
█                                                                                                                      █
████████████████████████████████████████████████████████████████████████████████████████████████████████████████████████